NO ./texture/.north.xpm
SO ./texture/south.xpm
EA ./texture/west.xpm
WE ./texture/east.xpm

F 200,100,150
C 300,300,650

111111111111111111111111111111111111111111
100000000000000000111111
1000100001111111000111
100001000111111111111
1000010001
100E000101
1000000001
1000010001
1000000101
1111111111