WE ./texture/east.xpm
NO ./texture/north.xpm
SO ./texture/south.xpm
EA ./texture/west.xpm

F 0,0,0
C 151,206,235





1111111111111
 111 10111    111111
1000101101111
1010010101
100010001
100100 0101
100000001
 1000010001
1000000101
1101111 1           11111
  11
 1001111
11011 1
11N1111
1111111



