NO ./texture/ve
SO ./texture/vec
EA ./texture/ve
                      WE ./texture/vector
C 255,2,0                       
F 205,155,110
111111111111111111
1000W0000000000001
100010000111000001
111000000000011111
100001011001110011
11110000011111100111111
11111111100001000000010111
11111111111111111111111  1      1111
1111 1 11  1111111
100010100110000111
100100000100000011
100000010111100011
100000010100001111
111111111111111111