WE                                                                          ./texture/east.xpm
NO                                            ./texture/north.xpm
                  SO                      ./texture/south.xpm
            EA              ./texture/west.xpm

          F                   2,0,0
                                                   C           255,0,0





1111111111111
111110111    111111
1000101101111
1010010101
100010001
1001000101
10001000111
1000E010001
1000000011
11011111           11111
11                        11111
111                        1001111
11011 1                     1111111
1101111
111111


